11111111111111111111111111111
12222222222221112222222222221
12111121111121112111112111131
12111121111121112111112111121
12222222222222222222222222221
12111121121111111112112111121
12222221122221112222112222221
12111121111101110111112111121
12111121111101110111112111121
12111121111101110111112111121
12111121100000000000112111121
12111121101111011110112111121
12222220001000000010002222221
12111121101111111110112111121
12111121100000000000112111121
12111121101111111110112111121
12222222222221112222222222221
12111121111121112111112111121
12221121111121112111112112221
11121122222222222222222112111
12222221112111111121112222221
13111111112111111121111111131
12222222222222222222222222221
11111111111111111111111111111